11111111111111111
1C0111110E0000C01
11000000000000001
110000P0100000001
11C00010000000001
11111111111111111
